1, 10, 20, 30, 30, 20, 10, 1
1, 1, 1, 1, 0, 1, 1, 1
10, 20, 110, 10, 500, 50, 1, 1
0, 101, 1, 1, 1, 0, 1, 1
1, 10, 20, 110, 10, 500, 50, 0
101, 1, 1, 1, 0, 1, 1, 1
10, 20, 110, 10, 500, 50, 0, 10